SID,HW1,HW2,Quiz,Mid-term,Final,Sum,Mean
S001,20,20,20,20,20,100,20.0
S002,8,20,20,20,10,78,15.6
S003,20,18,18,18,10,84,16.8
S004,20,20,20,18,10,88,17.6
S005,10,18,18,18,5,69,13.8
S006,18,18,18,15,5,74,14.8
S007,10,18,18,10,3,59,11.8
S008,20,20,20,20,15,95,19.0
S009,15,18,10,18,5,66,13.2
S010,19,17,17,17,17,87,17.4
S011,20,18,18,18,10,84,16.8
S012,20,18,18,18,5,79,15.8
S013,15,18,10,20,7,70,14.0
S014,5,15,10,10,15,55,11.0
S015,10,15,15,15,3,58,11.6
